//MAP CONVERTED BY dmm2tgm.py THIS HEADER COMMENT PREVENTS RECONVERSION, DO NOT REMOVE
"ap" = (
/obj/structure/shuttle/part/tornado/transparent{
	icon_state = "38"
	},
/turf/template_noop,
/area/shuttle/tornado)
"aX" = (
/turf/closed/shuttle/dropship3/tornado{
	icon_state = "25"
	},
/area/shuttle/tornado)
"bs" = (
/turf/closed/shuttle/dropship3/tornado{
	icon_state = "24"
	},
/area/shuttle/tornado)
"bZ" = (
/obj/structure/shuttle/part/tornado/transparent{
	icon_state = "32"
	},
/obj/effect/attach_point/fuel/tornado{
	layer = 3.1;
	dir = 1
	},
/turf/template_noop,
/area/shuttle/tornado)
"cy" = (
/obj/structure/shuttle/part/tornado/transparent{
	icon_state = "16"
	},
/turf/template_noop,
/area/shuttle/tornado)
"cD" = (
/obj/structure/shuttle/part/tornado/transparent{
	icon_state = "23"
	},
/turf/template_noop,
/area/shuttle/tornado)
"dn" = (
/turf/open/shuttle/dropship/light_grey_single_wide_up_to_down,
/area/shuttle/tornado)
"du" = (
/obj/structure/shuttle/part/tornado/transparent{
	icon_state = "33"
	},
/turf/template_noop,
/area/shuttle/tornado)
"dw" = (
/obj/structure/bed/chair/vehicle{
	dir = 1;
	pixel_x = -8
	},
/obj/structure/bed/chair/vehicle{
	dir = 1;
	pixel_x = 8
	},
/obj/docking_port/mobile/marine_dropship/tornado_long,
/turf/open/shuttle/dropship/medium_grey_single_wide_up_to_down,
/area/shuttle/tornado)
"dD" = (
/obj/structure/bed/chair/vehicle{
	dir = 1;
	pixel_x = 8
	},
/obj/structure/bed/chair/vehicle{
	dir = 1;
	pixel_x = -8
	},
/turf/open/shuttle/dropship/medium_grey_single_wide_up_to_down,
/area/shuttle/tornado)
"dO" = (
/obj/effect/decal/warning_stripes{
	icon_state = "S";
	pixel_y = 2
	},
/obj/effect/decal/warning_stripes{
	icon_state = "N";
	pixel_y = -1
	},
/turf/open/shuttle/dropship/medium_grey_single_wide_left_to_right,
/area/shuttle/tornado)
"ff" = (
/obj/structure/stairs/perspective{
	icon_state = "p_stair_full";
	can_block_movement = 0
	},
/obj/structure/platform{
	dir = 4
	},
/turf/open/shuttle/dropship/medium_grey_single_wide_up_to_down,
/area/shuttle/tornado)
"fT" = (
/obj/structure/shuttle/part/tornado/transparent{
	icon_state = "70"
	},
/turf/template_noop,
/area/shuttle/tornado)
"gF" = (
/obj/structure/shuttle/part/tornado/gunpod_prop,
/turf/template_noop,
/area/shuttle/tornado)
"hr" = (
/obj/structure/platform_decoration{
	dir = 8
	},
/obj/structure/machinery/camera/autoname/golden_arrow/tornado{
	dir = 8;
	pixel_x = 24
	},
/obj/structure/bed/chair/dropship/passenger/folded{
	dir = 8
	},
/turf/open/shuttle/dropship/medium_grey_single_wide_up_to_down,
/area/shuttle/tornado)
"jn" = (
/obj/structure/shuttle/part/tornado/transparent{
	icon_state = "95a"
	},
/turf/template_noop,
/area/shuttle/tornado)
"jV" = (
/obj/structure/shuttle/part/tornado/transparent{
	icon_state = "40";
	density = 0;
	layer = 4.2
	},
/turf/template_noop,
/area/shuttle/tornado)
"kv" = (
/obj/structure/stairs/perspective{
	icon_state = "p_stair_full";
	can_block_movement = 0
	},
/obj/structure/platform{
	dir = 8
	},
/turf/open/shuttle/dropship/medium_grey_single_wide_up_to_down,
/area/shuttle/tornado)
"kw" = (
/obj/structure/bed/chair/vehicle{
	pixel_x = 8
	},
/obj/structure/bed/chair/vehicle{
	pixel_x = -8
	},
/obj/structure/machinery/light/double{
	dir = 8;
	pixel_y = -5
	},
/turf/open/shuttle/dropship/medium_grey_single_wide_up_to_down,
/area/shuttle/tornado)
"lc" = (
/obj/structure/shuttle/part/tornado/transparent,
/turf/template_noop,
/area/shuttle/tornado)
"lq" = (
/obj/structure/shuttle/part/tornado/transparent{
	icon_state = "28"
	},
/turf/template_noop,
/area/shuttle/tornado)
"lu" = (
/obj/structure/stairs/perspective{
	dir = 1;
	icon_state = "p_stair_full";
	pixel_y = 22
	},
/obj/structure/bed/chair/vehicle/dropship_cockpit/copilot{
	dir = 1;
	layer = 5;
	pixel_x = 8
	},
/obj/structure/machinery/computer/dropship_weapons/tornado/small{
	pixel_y = 8;
	pixel_x = 8
	},
/turf/open/shuttle/dropship/medium_grey_single_wide_up_to_down,
/area/shuttle/tornado)
"lx" = (
/turf/closed/shuttle/dropship3/tornado{
	icon_state = "30"
	},
/area/shuttle/tornado)
"lA" = (
/turf/closed/shuttle/dropship3/tornado{
	icon_state = "76"
	},
/area/shuttle/tornado)
"lP" = (
/turf/closed/shuttle/dropship3/tornado{
	icon_state = "72"
	},
/area/shuttle/tornado)
"md" = (
/obj/structure/machinery/camera/autoname/golden_arrow/tornado{
	pixel_y = 32
	},
/turf/open/shuttle/dropship/light_grey_top_left,
/area/shuttle/tornado)
"mh" = (
/obj/structure/phone_base{
	dir = 4;
	pixel_x = -19;
	pixel_y = 12;
	layer = 3.1;
	phone_category = "Dropship";
	name = "Tornado telephone receiver";
	phone_id = "Tornado"
	},
/obj/structure/machinery/computer/shuttle/dropship/flight/small{
	pixel_y = 16;
	pixel_x = 6
	},
/obj/structure/bed/chair/vehicle/dropship_cockpit/pilot{
	dir = 1;
	pixel_x = 6;
	pixel_y = 8
	},
/turf/open/shuttle/dropship/medium_grey_single_wide_up_to_down,
/area/shuttle/tornado)
"mB" = (
/obj/structure/shuttle/part/tornado/transparent{
	icon_state = "3";
	density = 0;
	layer = 4.2
	},
/turf/template_noop,
/area/shuttle/tornado)
"oj" = (
/obj/structure/shuttle/part/tornado/transparent{
	icon_state = "35"
	},
/turf/template_noop,
/area/shuttle/tornado)
"oI" = (
/turf/closed/shuttle/dropship3/tornado{
	icon_state = "77"
	},
/area/shuttle/tornado)
"pa" = (
/obj/structure/machinery/light/double{
	dir = 8;
	pixel_y = -5
	},
/obj/structure/bed/chair/dropship/passenger/folded{
	dir = 4
	},
/turf/open/shuttle/dropship/medium_grey_single_wide_up_to_down,
/area/shuttle/tornado)
"pz" = (
/turf/closed/shuttle/dropship3/tornado{
	icon_state = "75"
	},
/area/shuttle/tornado)
"qa" = (
/obj/structure/shuttle/part/tornado/transparent{
	icon_state = "29"
	},
/turf/template_noop,
/area/shuttle/tornado)
"qi" = (
/obj/structure/shuttle/part/tornado/transparent{
	icon_state = "26"
	},
/turf/template_noop,
/area/shuttle/tornado)
"qk" = (
/obj/effect/decal/warning_stripes{
	icon_state = "N";
	pixel_y = -1
	},
/obj/effect/decal/warning_stripes{
	icon_state = "S";
	pixel_y = 2
	},
/obj/structure/machinery/door/airlock/multi_tile/almayer/dropshiprear/ds3{
	id = "aft_door";
	name = "\improper Tornado cargo door"
	},
/turf/open/shuttle/dropship/medium_grey_single_wide_left_to_right,
/area/shuttle/tornado)
"qA" = (
/obj/structure/bed/chair/vehicle{
	pixel_x = -8
	},
/obj/structure/bed/chair/vehicle{
	pixel_x = 8
	},
/turf/open/shuttle/dropship/medium_grey_single_wide_up_to_down,
/area/shuttle/tornado)
"ru" = (
/obj/structure/shuttle/part/tornado/transparent{
	icon_state = "32"
	},
/turf/template_noop,
/area/shuttle/tornado)
"sa" = (
/obj/structure/bed/chair/dropship/passenger/folded{
	dir = 8
	},
/turf/open/shuttle/dropship/medium_grey_single_wide_up_to_down,
/area/shuttle/tornado)
"sB" = (
/turf/closed/shuttle/dropship3/tornado{
	icon_state = "67"
	},
/area/shuttle/tornado)
"tg" = (
/turf/closed/shuttle/tornado/transparent{
	icon_state = "97a"
	},
/area/shuttle/tornado)
"vD" = (
/obj/structure/shuttle/part/tornado/transparent{
	icon_state = "4";
	density = 0;
	layer = 4.2
	},
/turf/template_noop,
/area/shuttle/tornado)
"wQ" = (
/obj/structure/machinery/camera/autoname/golden_arrow/tornado{
	dir = 4;
	pixel_x = -24
	},
/obj/structure/bed/chair/vehicle{
	dir = 1;
	pixel_x = 8
	},
/obj/structure/bed/chair/vehicle{
	dir = 1;
	pixel_x = -8
	},
/turf/open/shuttle/dropship/medium_grey_single_wide_up_to_down,
/area/shuttle/tornado)
"ya" = (
/obj/effect/attach_point/crew_weapon/tornado,
/turf/open/shuttle/dropship/medium_grey_single_wide_up_to_down,
/area/shuttle/tornado)
"yG" = (
/obj/structure/shuttle/part/tornado/transparent{
	icon_state = "27"
	},
/turf/template_noop,
/area/shuttle/tornado)
"Ak" = (
/turf/closed/shuttle/dropship3/tornado{
	icon_state = "47"
	},
/area/shuttle/tornado)
"As" = (
/obj/structure/shuttle/part/tornado/transparent{
	icon_state = "66"
	},
/turf/template_noop,
/area/shuttle/tornado)
"Bv" = (
/obj/structure/blocker/forcefield/multitile_vehicles,
/obj/structure/machinery/door/airlock/hatch/cockpit/three{
	dir = 1
	},
/turf/open/shuttle/dropship/medium_grey_single_wide_up_to_down,
/area/shuttle/tornado)
"Bx" = (
/obj/structure/shuttle/part/tornado{
	icon_state = "5"
	},
/turf/template_noop,
/area/shuttle/tornado)
"Cg" = (
/obj/structure/machinery/cm_vending/sorted/medical/wall_med{
	pixel_y = 26;
	pixel_x = -10
	},
/obj/structure/bed/chair/vehicle{
	pixel_x = 8
	},
/obj/structure/bed/chair/vehicle{
	pixel_x = -8
	},
/turf/open/shuttle/dropship/medium_grey_single_wide_up_to_down,
/area/shuttle/tornado)
"CM" = (
/turf/closed/shuttle/tornado/transparent{
	icon_state = "89b"
	},
/area/shuttle/tornado)
"DU" = (
/obj/structure/shuttle/part/tornado/transparent{
	icon_state = "61"
	},
/turf/template_noop,
/area/space)
"EI" = (
/obj/structure/shuttle/part/tornado{
	icon_state = "6"
	},
/turf/template_noop,
/area/shuttle/tornado)
"EM" = (
/obj/structure/shuttle/part/tornado/transparent{
	icon_state = "21"
	},
/turf/template_noop,
/area/shuttle/tornado)
"FG" = (
/turf/open/shuttle/dropship/light_grey_top_right,
/area/shuttle/tornado)
"Gx" = (
/obj/structure/bed/chair/vehicle{
	pixel_x = 8
	},
/obj/structure/bed/chair/vehicle{
	pixel_x = -8
	},
/turf/open/shuttle/dropship/medium_grey_single_wide_up_to_down,
/area/shuttle/tornado)
"GJ" = (
/obj/structure/shuttle/part/tornado/transparent/nosecone{
	icon_state = "102"
	},
/turf/template_noop,
/area/shuttle/tornado)
"Hv" = (
/turf/closed/shuttle/dropship3/tornado{
	icon_state = "18"
	},
/area/shuttle/tornado)
"HI" = (
/turf/closed/shuttle/dropship3/tornado{
	icon_state = "73"
	},
/area/shuttle/tornado)
"HW" = (
/obj/structure/shuttle/part/tornado/transparent{
	icon_state = "39"
	},
/turf/template_noop,
/area/shuttle/tornado)
"Is" = (
/obj/structure/shuttle/part/tornado/transparent{
	icon_state = "71"
	},
/turf/template_noop,
/area/shuttle/tornado)
"Jc" = (
/turf/closed/shuttle/dropship3/tornado{
	icon_state = "48"
	},
/area/shuttle/tornado)
"JK" = (
/turf/closed/shuttle/tornado/transparent{
	icon_state = "86b"
	},
/area/shuttle/tornado)
"JM" = (
/obj/structure/bed/chair/vehicle{
	dir = 1;
	pixel_x = -8
	},
/obj/structure/bed/chair/vehicle{
	dir = 1;
	pixel_x = 8
	},
/turf/open/shuttle/dropship/medium_grey_single_wide_up_to_down,
/area/shuttle/tornado)
"Ki" = (
/turf/closed/shuttle/dropship3/tornado{
	icon_state = "31"
	},
/area/shuttle/tornado)
"KU" = (
/turf/open/shuttle/dropship/light_grey_single_wide_left_to_right,
/area/shuttle/tornado)
"Ll" = (
/obj/structure/shuttle/part/tornado/transparent{
	icon_state = "28"
	},
/obj/effect/attach_point/fuel/tornado{
	layer = 3.1;
	dir = 1
	},
/turf/template_noop,
/area/shuttle/tornado)
"Ls" = (
/obj/structure/shuttle/part/tornado/transparent{
	icon_state = "22"
	},
/turf/template_noop,
/area/shuttle/tornado)
"Lt" = (
/obj/structure/bed/chair/dropship/passenger/folded{
	dir = 4
	},
/turf/open/shuttle/dropship/medium_grey_single_wide_up_to_down,
/area/shuttle/tornado)
"Lv" = (
/turf/closed/shuttle/dropship3/tornado{
	icon_state = "104"
	},
/area/shuttle/tornado)
"LI" = (
/obj/structure/shuttle/part/tornado/transparent{
	icon_state = "20"
	},
/turf/template_noop,
/area/shuttle/tornado)
"MG" = (
/obj/structure/bed/chair/vehicle{
	pixel_x = -8
	},
/obj/structure/bed/chair/vehicle{
	pixel_x = 8
	},
/obj/structure/machinery/light/double{
	dir = 4;
	pixel_y = -5
	},
/turf/open/shuttle/dropship/medium_grey_single_wide_up_to_down,
/area/shuttle/tornado)
"MH" = (
/obj/structure/shuttle/part/tornado{
	icon_state = "2"
	},
/turf/template_noop,
/area/shuttle/tornado)
"NU" = (
/obj/structure/platform_decoration{
	dir = 4
	},
/obj/structure/bed/chair/dropship/passenger/folded{
	dir = 4
	},
/turf/open/shuttle/dropship/medium_grey_single_wide_up_to_down,
/area/shuttle/tornado)
"NZ" = (
/turf/closed/shuttle/dropship3/tornado{
	icon_state = "19"
	},
/area/shuttle/tornado)
"Ox" = (
/obj/structure/shuttle/part/tornado/transparent{
	icon_state = "41";
	layer = 4.2;
	density = 0
	},
/turf/template_noop,
/area/shuttle/tornado)
"OK" = (
/obj/structure/stairs/perspective{
	icon_state = "p_stair_full";
	can_block_movement = 0
	},
/turf/open/shuttle/dropship/light_grey_single_wide_up_to_down,
/area/shuttle/tornado)
"Pf" = (
/turf/closed/shuttle/tornado/transparent{
	icon_state = "89a"
	},
/area/shuttle/tornado)
"QE" = (
/obj/structure/shuttle/part/tornado/transparent{
	icon_state = "46";
	density = 0;
	layer = 4.2
	},
/turf/template_noop,
/area/shuttle/tornado)
"Ru" = (
/turf/closed/shuttle/dropship3/tornado{
	icon_state = "83"
	},
/area/shuttle/tornado)
"RA" = (
/obj/structure/shuttle/part/tornado/transparent{
	icon_state = "65"
	},
/turf/template_noop,
/area/space)
"RH" = (
/obj/structure/machinery/light/double{
	dir = 4;
	pixel_y = -5
	},
/obj/structure/bed/chair/dropship/passenger/folded{
	dir = 8
	},
/turf/open/shuttle/dropship/medium_grey_single_wide_up_to_down,
/area/shuttle/tornado)
"Ul" = (
/turf/open/shuttle/dropship/light_grey_bottom_left,
/area/shuttle/tornado)
"UK" = (
/turf/closed/shuttle/dropship3/tornado{
	icon_state = "103"
	},
/area/shuttle/tornado)
"Vt" = (
/obj/structure/shuttle/part/tornado/transparent{
	icon_state = "34"
	},
/turf/template_noop,
/area/shuttle/tornado)
"VB" = (
/turf/template_noop,
/area/space)
"Xa" = (
/obj/structure/shuttle/part/tornado/transparent/nosecone{
	icon_state = "100"
	},
/turf/template_noop,
/area/shuttle/tornado)
"Xe" = (
/turf/closed/shuttle/dropship3/tornado{
	icon_state = "69"
	},
/area/shuttle/tornado)
"Xq" = (
/obj/structure/shuttle/part/tornado/transparent{
	icon_state = "17"
	},
/turf/template_noop,
/area/shuttle/tornado)
"Xs" = (
/turf/closed/shuttle/dropship3/tornado{
	icon_state = "62"
	},
/area/shuttle/tornado)
"XM" = (
/turf/closed/shuttle/tornado/transparent{
	icon_state = "86a"
	},
/area/shuttle/tornado)
"Yw" = (
/turf/closed/shuttle/dropship3/tornado{
	icon_state = "64"
	},
/area/shuttle/tornado)
"Yx" = (
/obj/structure/shuttle/part/tornado/transparent{
	icon_state = "99a"
	},
/turf/template_noop,
/area/shuttle/tornado)
"YB" = (
/obj/structure/shuttle/part/tornado/transparent{
	icon_state = "74"
	},
/turf/template_noop,
/area/shuttle/tornado)
"YW" = (
/obj/structure/shuttle/part/tornado/transparent{
	icon_state = "49";
	density = 0;
	layer = 4.2
	},
/turf/template_noop,
/area/shuttle/tornado)
"Zi" = (
/turf/open/shuttle/dropship/light_grey_bottom_right,
/area/shuttle/tornado)
"ZM" = (
/obj/structure/machinery/cm_vending/sorted/medical/wall_med{
	pixel_y = 26;
	pixel_x = 10
	},
/obj/structure/extinguisher_cabinet/lifeboat{
	pixel_y = 27;
	pixel_x = -2
	},
/obj/structure/bed/chair/vehicle{
	pixel_x = 8
	},
/obj/structure/bed/chair/vehicle{
	pixel_x = -8
	},
/turf/open/shuttle/dropship/medium_grey_single_wide_up_to_down,
/area/shuttle/tornado)

(1,1,1) = {"
VB
VB
VB
VB
VB
VB
VB
VB
VB
VB
jV
Vt
Ll
Ls
LI
VB
VB
VB
VB
VB
VB
"}
(2,1,1) = {"
VB
VB
VB
VB
VB
Is
As
As
DU
VB
Ox
oj
qa
cD
EM
VB
jV
lq
Ls
LI
lc
"}
(3,1,1) = {"
VB
VB
VB
jV
pz
lP
sB
sB
Xs
JK
XM
Hv
Hv
lx
bs
QE
Ox
qa
cD
EM
MH
"}
(4,1,1) = {"
VB
VB
VB
Ox
lA
ZM
dD
kw
wQ
Gx
Gx
Gx
kw
JM
dD
Ak
Hv
lx
bs
UK
mB
"}
(5,1,1) = {"
Xa
jn
JK
XM
oI
md
dn
dn
dn
dn
dn
dn
dn
dn
Ul
kv
NU
pa
Lt
qk
VB
"}
(6,1,1) = {"
gF
tg
mh
lu
Bv
KU
qA
JM
JM
Gx
JM
dw
JM
ya
KU
OK
dn
dn
dn
dO
VB
"}
(7,1,1) = {"
GJ
Yx
CM
Pf
oI
FG
dn
dn
dn
dn
dn
dn
dn
dn
Zi
ff
hr
RH
sa
dO
VB
"}
(8,1,1) = {"
VB
VB
VB
jV
lA
Cg
JM
MG
dD
qA
qA
qA
MG
JM
JM
Jc
NZ
Ki
aX
Lv
vD
"}
(9,1,1) = {"
VB
VB
VB
Ox
Ru
HI
Xe
Xe
Yw
CM
Pf
NZ
NZ
Ki
aX
YW
jV
ru
qi
cy
Bx
"}
(10,1,1) = {"
VB
VB
VB
VB
VB
YB
fT
fT
RA
VB
jV
ap
bZ
qi
cy
VB
Ox
du
yG
Xq
EI
"}
(11,1,1) = {"
VB
VB
VB
VB
VB
VB
VB
VB
VB
VB
Ox
HW
du
yG
Xq
VB
VB
VB
VB
VB
VB
"}
